29 30 31 32 43 46 49 46 47 32 38 39 40 41 42 32 43 44 45 46 47 32 48 49 29 30 31 32 33 34 35 36 37 32 38 39 40 41 42 32 43 44 45 46 47 32 48 49
11 12 13 14 25 26 28 26 13 14 20 21 22 23 24 14 25 26 27 26 13 14 25 28 11 12 13 14 15 16 17 18 19 14 20 21 22 23 24 14 25 26 27 26 13 14 25 28
29 30 31 32 43 46 49 46 47 32 38 39 40 41 42 32 43 44 45 46 47 32 48 49 29 30 31 32 33 34 35 36 37 32 38 39 40 41 42 32 43 44 45 46 47 32 48 49
11 12 13 14 25 26 28 26 13 14 20 21 22 23 24 14 25 26 27 26 13 14 25 28 11 12 13 14 15 16 17 18 19 14 20 21 22 23 24 14 25 26 27 26 13 14 25 28
29 30 31 32 43 46 49 46 47 32 38 39 40 41 42 32 43 44 45 46 47 32 48 49 29 30 31 32 33 34 35 36 37 32 38 39 40 41 42 32 43 44 45 46 47 32 48 49
11 12 13 14 15 16 17 18 19 14 20 21 22 23 24 14 25 26 27 26 13 14 25 28 11 12 13 14 15 16 17 18 19 14 20 21 22 23 24 14 25 26 27 26 13 14 25 28
29 30 31 32 33 34 35 36 37 32 38 39 40 41 42 32 43 44 45 46 47 32 48 49 29 30 31 32 33 34 35 36 37 32 38 39 40 41 42 32 43 44 45 46 47 32 48 49
50 50 50 50 50 50 50 50 50 50 50 50 50 50 50 50 50 50 50 50 50 50 50 50 50 50 50 50 50 50 50 50 50 50 50 50 50 50 50 50 50 50 50 50 50 50 50 50
51 51 51 51 51 51 51 51 51 51 51 51 51 51 51 51 51 51 51 51 51 51 51 51 51 51 51 51 51 51 51 51 51 51 51 51 51 51 51 51 51 51 51 51 51 51 51 51
52 52 52 52 52 52 52 52 52 52 52 52 52 52 52 52 52 52 52 52 52 52 52 52 52 52 52 52 52 52 52 52 52 52 52 52 52 52 52 52 52 52 52 52 52 52 52 52
53 53 53 53 53 53 53 53 53 53 53 53 53 53 53 53 53 53 53 53 53 53 53 53 53 53 53 53 53 53 53 53 53 53 53 53 53 53 53 53 53 53 53 53 53 53 53 53
54 54 54 54 54 54 54 54 54 54 54 54 54 54 54 54 54 54 54 54 54 54 54 54 54 54 54 54 54 54 54 54 54 54 54 54 54 54 54 54 54 54 54 54 54 54 54 54 
55 55 55 55 55 55 55 55 55 55 55 55 55 55 55 55 55 55 55 55 55 55 55 55 55 55 55 55 55 55 55 55 55 55 55 55 55 55 55 55 55 55 55 55 55 55 55 55
55 55 55 55 55 55 55 55 55 55 55 55 55 55 55 55 55 55 55 55 55 55 55 55 55 55 55 55 55 55 55 55 55 55 55 55 55 55 55 55 55 55 55 55 55 55 55 55
55 55 55 55 55 55 55 55 55 55 55 55 55 55 55 55 55 55 55 55 55 55 55 55 55 55 55 55 55 55 55 55 55 55 55 55 55 55 55 55 55 55 55 55 55 55 55 55
55 55 55 55 55 55 55 55 55 55 55 55 55 55 55 55 55 55 55 55 55 55 55 55 55 55 55 55 55 55 55 55 55 55 55 55 55 55 55 55 55 55 55 55 55 55 55 55
55 55 55 55 55 55 55 55 55 55 55 55 55 55 55 55 55 55 55 55 55 55 55 55 55 55 55 55 55 55 55 55 55 55 55 55 55 55 55 55 55 55 55 55 55 55 55 55
54 54 54 54 54 54 54 54 54 54 54 54 54 54 54 54 54 54 54 54 54 54 54 54 54 54 54 54 54 54 54 54 54 54 54 54 54 54 54 54 54 54 54 54 54 54 54 54
53 53 53 53 53 53 53 53 53 53 53 53 53 53 53 53 53 53 53 53 53 53 53 53 53 53 53 53 53 53 53 53 53 53 53 53 53 53 53 53 53 53 53 53 53 53 53 53
52 52 52 52 52 52 52 52 52 52 52 52 52 52 52 52 52 52 52 52 52 52 52 52 52 52 52 52 52 52 52 52 52 52 52 52 52 52 52 52 52 52 52 52 52 52 52 52
51 51 51 51 51 51 51 51 51 51 51 51 51 51 51 51 51 51 51 51 51 51 51 51 51 51 51 51 51 51 51 51 51 51 51 51 51 51 51 51 51 51 51 51 51 51 51 51
51 51 51 51 51 51 51 51 51 51 51 51 51 51 51 51 51 51 51 51 51 51 51 51 51 51 51 51 51 51 51 51 51 51 51 51 51 51 51 51 51 51 51 51 51 51 51 51
51 51 51 51 51 51 51 51 51 51 51 51 51 51 51 51 51 51 51 51 51 51 51 51 51 51 51 51 51 51 51 51 51 51 51 51 51 51 51 51 51 51 51 51 51 51 51 51